6,6
######
#S...#
#.#..#
#.#..#
#...##
#..F.#
1,1
6,5
