10,10
##########
#S....#..#
#.#.#..###
#.#.#..#.#
#.#.####.#
#.#......#
#.#######F
#........#
##########
1,1
7,8