12,12
############
#S.........#
#.########.#
#.#......#.#
#.#.####.#.#
#.#.#..#.#.#
#.#.#..#.#.#
#.#.#..#.#.#
#.#.#..#.#.#
#.#.##...#.#
#.....####.#
###########F
1,1
12,11
